{
    "MAP1": [
        "00000000000100000000000000000000001000000000000000",
        "00000000000000000000000000000000000000000000000000",
        "00000000000000000000000000000000000000000000000000",
        "00000000000000000000000000000000000000000000000000",
        "00000000000000000000000000000000000000000000000000",
        "00000000000100000000000000000000001000000000000000",
        "00000000000000000000000000000000000000000000000000",
        "00000000000000000000000000000000000000000000000000",
        "00000000000000000000000000000000000000000000000000",
        "00000000000000000000000000000000000000000000000000",
        "00000000000100000000000000000000001000000000000000",
        "00000000000000000000000000000000000000000000000000",
        "00000000000000000000000000000000000000000000000000",
        "00000000000000000000000000000000000000000000000000",
        "00000000000000000000000000000000000000000000000000",
        "00000000000100000000000000000000001000000000000000",
        "00000000000000000000000000000000000000000000000000",
        "00000000000000000000000000000000000000000000000000",
        "00000000000000000000000000000000000000000000000000",
        "00000000000020000200000002000020000200000002000020",
        "00000000000000000000000000000000000000000000000000",
        "00000000000000000000000000000000000000000000000000",
        "00000000000000000000000000000000000000000000000000",
        "00000000000000000000000000000000000000000000000000",
        "00000000000000000000000000000000000000000000000000",
        "00000000000000000000000000000000000000000000000000",
        "00000000000120000000200002000020000200002000020000",
        "00000000000000000000000000000000000000000000000000",
        "00000000000000000000000000000000000000000000000000",
        "00000000000000000000000000000000000000000000000000",
        "00000000000000000000000000000000000000000000000000",
        "00000000000100000000000000000000000000000000000000",
        "00000000000000000000000000000000000000000000000000",
        "00000000000000000000000000000000000000000000000000",
        "00000000000000000000000000000000000000000000000000"
    ]
}